5 x 10
**********
* R   R  *
*   * *  *
* * H  R *
**********