10 x 19
         *      
        *+*     
       * R *    
      O     *
     *       *
    *    H    *
   * *   +++   O
  *  *     R *  *
 *   R           *
*******O***********