5 x 10
**O*******
* R + R  O
*   + *  *
* * H  R *
**********