10 x 20
********************
* R  *      R      *
*             *    *
*  *               *
*        H       R *
*       *          *
* R          *     *
*  ****     R      *
*                  *
********************